NO ./textures/purplestone.xpm
SO ./textures/purplestone.xpm
WE ./textures/purplestone.xpm
EA ./textures/purplestone.xpm
F 220,100,0
C 225,30,0
              1111111              
           1110000000111           
         11000000000000011         
       110000000000000000011       
      10000000000000000000001      
     1000000000000000000000001     
    100000000000000000000000001    
   10000000000000000000000000001   
   10000000000000000000000000001   
  1000000000000000000000000000001  
  1000000000000000000000000000001  
 100000000000000000000000000000001 
 100000000000000000000000000000001 
 100000000000000000000000000000001 
10000000000000000000000000000000001
10000000000000000000000000000000001
1000000000000000S000000000000000001
10000000000000000000000000000000001
10000000000000000000000000000000001
10000000000000000000000000000000001
10000000000000000000000000000000001
 100000000000000000000000000000001 
 100000000000000000000000000000001 
 100000000000000000000000000000001 
  1000000000000000000000000000001  
  1000000000000000000000000000001  
   10000000000000000000000000001   
   10000000000000000000000000001   
    100000000000000000000000001    
     1000000000000000000000001     
      10000000000000000000001      
       110000000000000000011       
         11000000000000011         
           1110000000111           
              1111111              
