         
   NO                   ./textures/background1.xpm




        SO   ./textures/background2.xpm

                      WE     ./textures/background3.xpm




EA                    ./textures/background4.xpm


F 220,   100,0   



C              225, 30,  0



111111111111111111
111111111111111111
111E00000000000111
110000000000000011
110000011111110111
110000011111110111
111000111111110111
111110000000000111
111110111110111111
111110111110111111
111110111110111111
110000000000000111
110000111111100111
110111110000000111
110000000000000011
111111111111111111








