NO ./path_to_the_north_texture
SO ./path_to_the_south_texture
WE ./path_to_the_west_texture
EA ./path_to_the_east_texture
F 220,100,0
C 225,30,0
1
11
101
1001
10001
100001
1000001
10000001
100000001
1000000001
10000000001
100000000001
1000000000001
10000000000001
100000000000001
1000000000000001
10000000000000001
111111111111111111
